0060060000600006
8010011100800110
6010600600000000
0010000000060007
0011111111111100
6000006000000100
0060000000000106
0111111111100100
0006000080000606
0022200006000000
0000000000000200
0600011111100206
0000010006100200
0600000600106000
1001100000100006
6000010050000000

6070000600100006
0000106000000668
1101111101111011
0000800106600066
6000000100806000
1111011111110111
6006000006000000
0001000000010006
1111101161110111
0060060100000000
6000000100006000
0011111111161011
0001000000000006
0600006001000000
0001000001060060
0001005001000000

7004000060840600
0004006000040007
0600000800600060
0060400060406000
6000046004000060
0006004440060000
0020060000000206
6020000600600200
0024444444444200
0020600000000206
6060000600060000
0000224444220000
0220200060020020
0000205060620020
0220000000000020
6060060006000006

0703000306030000
6000600300000060
0003060300036008
6063000060033333
3033000300600060
0063006333330006
6603000060036080
6003080306030060
0000000300033033
0063333306030000
6003060300006000
0333000333330006
0603000300033033
0000060000030006
6003000306036060
0003060050030006

0060860000600007
0222220222222226
0206000604070620
6200060600600020
0222222222222026
0000060000060000
6022222006008006
0020602000000060
0006062006044400
6022222000000060
0006030006006000
0600060022222222
0044000020066000
6040006060000006
0440600000044400
0600060506000006

8060070060006006
3033333333333330
6000660000600607
0333333333333303
7300306300300306
0306306300306300
6400400400400406
0060600060006000
6333333333330006
0360006006060306
0303333333003330
6303000066000600
0060333336006006
0306060036222002
0330333630000060
6006003035060606

6000060070006008
0044444444444400
0046100006000601
0646006100106000
0044444444444400
6008000060060406
1000010000060408
0044444444444400
0640600660016060
0040601006060006
0044444446004444
6000660040060006
0006000640004444
0644444440006060
0040004006060060
6000506006006006

6000360006000676
0030022222222230
0627000300600606
0020603222236003
0030006003000007
0300300060003060
6000603000300003
8023004060200460
0020030630200002
0620003060200600
3020060000304402
0030033360000606
6000600000006002
0002222222222200
0602006002002006
0000600060500600

6006070600006006
0111111111111110
0106006060004007
0100440000804040
4160046010104040
0000600010100040
6111111110111111
0100000000060060
0106000800000006
6160111111111111
0100100600060606
0106111111111011
6100000004006060
0164060600000406
0111111111111100
6006000600060050

6040600760000600
0606006000600006
3220022222222223
0060000600006007
7000600600600060
3222222300223200
0600600206002000
0000060260062007
0060000322223000
6000806000600600
0032002223003023
0620006062062060
0020660002002600
6032220223002006
0006000000062606
0600060500003060

0060606070006006
6033333333333330
0036060600600830
0137100010001000
6300000006006006
0301000100010010
6360700060066000
0310010001001607
0300006000607000
6301000100010010
0306600606000060
1001111111111110
6001000006000600
0001600100001006
0600000100601000
0001006150000006

7000600606070600
0060006060600006
6044444444444444
0600670600060066
0006000700600600
4444444444444406
0007060006000006
0600000600060000
0004444444444446
6400600600006000
0400000060640006
0444444446004440
0460000600060406
6400660006060046
0444444444444440
0060000500600600

8001181111117111
6170006646060071
0106000600016061
6101111106010001
0161607160416061
0101006100610601
6101440100010601
0161006106010001
0101800140010601
6161044166010006
0100606100010600
6160060106410044
0101060100610600
0161000111110044
0101060060600600
6101005006060006

7040700086000407
6040006000060460
0060603063000006
6000030000300600
4400360606030044
0606306060030060
0000036000300600
7006003073060008
0060600330606060
4444006006004444
0606000600606060
4444444444444440
0060006006000600
0444444444444444
0060006000060006
0006000050000600

0600606680600686
1111111111111306
0060060760606608
6031111111111111
0060670060060706
1111113003111111
0000600007600606
0311111111111130
6000060060600600
6611103111113001
0000100606010060
0060106000610000
1111111111011001
0060060006010060
0060611111111111
0600600500600600

8060060600706008
4444404040000406
4607460044060460
4060004040406406
4440004640740407
4060004046004400
4000704040060406
6006006000600600
0060600060060006
3330111111111110
0606036000600606
6006030060040006
0033330003333333
0630600600600060
0033333333333600
0600000050060006